0000000000000000000000000
0000rr0000000000000022222
00000r000000000r000222332
0000000000000000000233332
00000rr000000000000233332
0000000000000000000233332
0000000000000000002223f32
1111111111111111133333f3w
0000000000000000002223f32
0000r000000rr000000233332
00000000000r0000000233332
0000r00000000000000233332
0000000000000000000222332
0000000000000000000022222
0000000000000000000000000