empty map full of random tiles has the format:
        "0000000000000000000000000" \
        "0000000000000000000000000" \
        "0000000000000000000000000" \
        "0000000000000000000000000" \
        "0000000000000000000000000" \
        "0000000000000000000000000" \
        "0000000000000000000000000" \
        "0000000000000000000000000" \
        "0000000000000000000000000" \
        "0000000000000000000000000" \
        "0000000000000000000000000" \
        "0000000000000000000000000" \
        "0000000000000000000000000" \
        "0000000000000000000000000" \
        "0000000000000000000000000"
Starter map with win tiles in correct position (same place always) as w
        "0000000000000000w00000000" \
        "0000000000000000000000000" \
        "0000000000000000000000000" \
        "0000000000000000000000000" \
        "0000000000000000000000000" \
        "0000000000000000000000000" \
        "0000000000000000000000000" \
        "000000000000000000000000w" \
        "0000000000000000000000000" \
        "0000000000000000000000000" \
        "0000000000000000000000000" \
        "0000000000000000000000000" \
        "0000000000000000000000000" \
        "0000000000000000000000000" \
        "00000000w0000000000000000"

Dictionary
0 =
1 =
2 =
3 =
4 =
5 =