rrrrrrrrrrrrrrrrrrrrrrrrr
0000000000000000000222220
0000000000000000002223320
0000000000000000002333320
0000000000000000002333320
0000000000000000002333320
0000000000000000022233320
1111111111111111333333333
0000000000000000022233320
0000000000000000002333320
0000000000000000002333320
0000000000000000002333320
0000000000000000002223320
0000000000000000000222220
0000000000000000000000000