0000000000000000000000000
000rr00000000000000222220
0000r000000000r0002223320
0000000000000000002333320
0000000000000000002333320
0000000000000000002333320
000000000000000002223f320
111111111111111133333f333
000000000000000002223f320
0000000000000000002333320
0000000000rr0000002333320
000r000000r00000002333320
0000000000000000002223320
0000000000000000000222220
0000000000000000000000000