0000000000000r00000000000
0000000000000000000022222
000000000000000r000222332
00r0000000rr0000000233332
00000rr000000000000233332
0000000000000r00002233332
000000000000000000K223f32
111111111111111111KR33f3w
000000000000000000K223f32
000000000000r000002233332
0000000000000000000233332
000000000000r000000233332
000000000000000r000222332
0000000000000000000022222
000000000000r000000000000