0000000000000000000000000
0000000000000000000022222
0000000000000000000222332
0000000000000000000233332
0000000000000000000233332
0000000000000000002233332
000000000000KKK0002223f32
111111111111KRK1113333f3w
000000000000KKK0002223f32
0000000000000000002233332
0000000000000000000233332
0000000000000000000233332
0000000000000000000222332
0000000000000000000022222
0000000000000000000000000