0000000000000000000000000
0000000000000000000022222
0000000000000000000222332
0000000000r00000000233332
00000000000000r0000233332
00000000r0000000002233f32
0000000000000K00R03333f32
111111111111111R1133f3f3w
0000000000000K00R03333f32
00000000000000r0002233f32
0000000000000000000233332
0000000000r00000000233332
0000000000000000000222332
000000000000r000000022222
0000000000000000000000000