0000000000000000000000000
0000000000000000000022222
0000000000000000r00222332
0000000000000000000233332
00000000000000K0000233332
0000000000000000r02233332
000000000000000r001333f32
1111111111111111113333f3w
000000000000000r001333f32
00000000r00000r0000233332
00000000000000r0000233332
0000000000000000r00233332
0000000000000000000222332
0000000000000000000022222
0000000000000000000000000